12
6
20
20
0s010101011110101100
01111111110011111110
01010100111010010010
11111111101010111110
10101001001110100100
10101011011010000100
11111010010011111100
10010011110001000000
10111110101111111110
10010000100100010010
10011000100101110010
11001111111101010110
01110100000101110100
01010111001111011110
01110101101001010010
00011100111111110010
00110000100101010010
01111100100101011110
01000111111101000010
011111000101110000j0
