5
10
30
25
0s0111111111100011000000000000
011111000100111r11111111111110
000010001110100100101000000010
1111111v1010101111101000111110
10100001001r101001001000100010
101010110110100001111110100010
1r111010010011111v000011100010
100000v111000v0000000010100010
101111101011111v11100011111110
100100001001000100100010000100
1001v0001001011100111110000100
11001111111v010001100010000100
011101000001010001010011111100
00010v110011110111111000010000
000101011010000100001000010000
000111001011111100001111111110
001v00001001000100001001000010
001111001001000111111001000010
000001111111000100100001000010
011111010000000100111111111110
010000010000111100001000010000
011100010011100100001000010000
000111111110000100111110010000
011100000000000111100011111110
0000000000000000000000000000j0